20 14
2 2 2 2 2 2 2 2 2 2 2 2 2 2 2 2 2 2 2 2
2 3 3 5 0 2 0 0 0 2 0 0 0 0 0 0 0 0 0 2
2 0 3 0 0 2 0 0 0 2 2 0 3 0 0 2 0 0 0 2
2 0 3 0 0 2 0 0 0 2 2 0 3 0 0 2 0 0 0 2 
2 0 3 0 5 2 0 0 0 2 2 0 3 0 0 2 0 0 0 2
2 0 3 3 3 2 0 0 0 2 2 0 3 0 0 2 0 0 0 2
2 5 0 0 3 2 0 0 0 2 2 0 3 0 0 2 0 0 0 2
2 0 0 0 0 2 0 0 0 2 2 0 3 0 0 2 0 0 0 2
2 0 0 0 0 2 0 0 0 2 2 0 3 0 0 2 0 0 0 2
2 2 2 2 2 2 2 2 2 2 2 2 2 2 2 2 2 2 2 2
2 2 2 2 2 2 2 2 2 2 2 2 2 2 2 2 2 2 2 2
2 2 2 2 2 2 2 2 2 2 2 2 2 2 2 2 2 2 2 2
2 2 2 2 2 2 2 2 2 2 2 2 2 2 2 2 2 2 5 2
2 2 2 2 2 2 2 2 2 2 2 2 2 2 2 2 2 2 2 2