20 14
1 1 1 1 1 1 1 1 1 1 1 1 1 1 1 1 1 1 1 1
1 3 3 6 3 1 3 3 3 3 1 3 3 3 3 1 3 3 3 1
1 3 3 3 3 1 3 3 3 3 1 3 3 3 3 1 3 3 6 1
1 3 3 3 3 1 3 3 3 3 1 3 3 3 3 1 6 3 3 1 
1 3 3 3 6 1 3 3 3 3 1 3 3 3 3 1 3 3 3 1
1 3 3 3 3 1 3 3 3 3 1 3 3 3 3 1 3 6 3 1
1 6 3 3 3 1 3 3 3 3 1 3 3 3 3 1 3 3 3 1
1 3 3 3 3 1 3 3 3 3 1 3 3 3 3 1 3 3 3 1
1 3 3 3 3 1 3 3 3 3 1 3 3 3 3 3 3 3 3 1
1 3 3 3 3 1 3 3 3 3 1 3 3 3 3 1 3 3 3 1
1 3 3 3 3 1 3 3 3 3 1 3 3 6 6 1 3 3 3 1
1 3 3 6 3 1 3 3 3 3 1 3 3 6 6 1 3 3 3 1
1 3 3 3 3 1 3 3 3 3 1 3 3 3 3 1 3 3 1 1
1 1 1 1 1 1 1 1 1 1 1 1 1 1 1 1 1 1 1 1