20 14
2 2 2 2 2 2 2 2 2 2 2 2 2 2 2 2 2 2 2 2
2 3 3 5 0 2 0 0 0 0 2 0 3 0 0 2 0 0 0 2
2 0 3 0 0 2 0 0 0 0 2 0 3 0 0 2 0 0 5 2
2 0 3 0 0 2 0 0 0 0 2 0 3 0 0 2 5 0 0 2 
2 0 3 0 5 2 0 0 0 0 2 0 3 0 0 2 0 0 0 2
2 0 3 3 3 2 0 0 0 0 2 0 3 0 0 2 0 5 0 2
2 5 0 0 3 2 0 0 0 0 2 0 3 0 0 2 0 0 0 2
1 3 3 3 3 1 3 3 3 3 1 3 3 3 3 1 3 3 3 1
1 3 3 3 3 1 3 3 3 3 1 3 3 3 3 3 3 3 3 1
1 3 3 3 3 1 3 3 3 3 1 3 3 3 3 1 3 3 3 1
1 3 3 3 3 1 3 3 3 3 1 3 3 6 6 1 3 3 3 1
1 3 3 6 3 1 3 3 3 3 1 3 3 6 6 1 3 3 3 1
1 3 3 3 3 1 3 3 3 3 1 3 3 3 3 1 3 3 1 1
1 1 1 1 1 1 1 1 1 1 1 1 1 1 1 1 1 1 1 1