20 14
2 2 2 2 2 2 2 2 2 4 2 2 2 2 2 2 2 2 2 2
2 1 1 1 1 2 0 0 0 0 2 0 0 0 0 2 0 0 0 2
2 1 1 7 1 2 0 0 0 0 2 0 0 0 0 2 0 0 5 2
2 1 1 1 1 2 0 0 0 0 2 0 0 0 0 2 5 0 0 2 
2 1 1 1 1 2 0 0 0 0 2 0 0 0 0 2 0 0 0 2
2 1 1 1 7 2 0 0 0 0 2 0 0 0 0 2 0 5 0 2
2 1 7 1 1 2 0 0 0 0 2 0 0 0 0 2 0 0 0 2
2 1 1 1 1 2 0 0 0 0 2 0 0 0 0 2 0 0 0 2
2 1 1 7 1 2 0 0 0 0 2 0 0 0 0 2 0 0 0 2
2 1 1 1 1 2 0 0 0 0 2 0 0 0 0 2 0 0 0 4
2 1 1 1 1 2 0 0 0 0 2 0 0 0 0 2 0 0 0 2
2 1 7 1 1 2 0 0 0 0 2 0 0 0 0 2 5 0 5 5
2 1 1 1 1 2 0 0 0 0 2 0 0 0 0 2 5 0 0 5
2 2 2 2 2 2 2 2 2 2 2 2 2 2 2 2 5 5 0 0